###############
###         ###
##           ##
##           ##
#             #
#             #
#             #
#   BBBBBBB   #
#             #
#             #
#             #
##           ##
##           ##
###         ###
###############