###############
###         ###
##           ##
##           ##
#             #
#             #
#             #
#     BBB     #
#             #
#             #
#             #
##           ##
##           ##
###    R    ###
###############